1111111111111111111111
100P0000000C0000000001
100000000E000000000001
1000000000000000000001
1111111111111111111111