1111111111111
1001C000000C1
1000011111001
1P00011E00001
1111111111111